NNNNNNNNNNNNNNNNNNNNNNNNNNNNNNNN
N                              N
N                              N
N                              N
N             P                N
N                              N
N                              N
N                              N
N                              N
N                              N
N                              N
N                              N
N                              N
N                              N
N                              N
N                              N
N                              N
NNNNNNNNNNNNNNNNNNNNNNNNNNNNNNNN