NNNNNNNNNNNNNNNNNNNNNNNNNNNNNNNN
N                              N
N           G                  N
N                              N
N             P                N
N                              N
N                              N
N            G                 N
N                              N
N                G             N
N                              N
N                              N
N                              N
N                 G            N
N            G                 N
N                              N
N                              N
NNNNNNNNNNNNNNNNNNNNNNNNNNNNNNNN