PNNNNNNNNN
N        N
N        N
N        N
N        N
N        N
N        N
NNNNNNNNNN
