NNNNNNNNNNNNNNNNNNNNNNNNNNNNNNNN
N             N                N
N           G N                N
N            NNN               N
N         NNNNPNNNN            N
N            NNNNN             N
N             N                N
N            GN                N
N                              N
N                G             N
N                              N
N                              N
N                              N
N                 G            N
N            G                 N
N                              N
N                              N
NNNNNNNNNNNNNNNNNNNNNNNNNNNNNNNN