NNNNNNNNNNNNNNNNNNNNNNNNNNNNNNNN
N             N                N
N           GNN                N
N            NNN               N
N         NNNNPNNNN            N
N            NNNNN             N
N             N                N
NNNNNNNNNNNNNGN                N
N                              N
N                GNNNNNNNNNNNNNN
N                              N
N                              N
N                              N
N                 GNNNNNNNNNNNNN
N            G                 N
N            N                 N
N            N                 N
NNNNNNNNNNNNNNNNNNNNNNNNNNNNNNNN